{
	"tiles": [
		{
			"id": 1,
			"frames": [
				{
					"framePosition": [24,24], "frameSize": [24,24]
				}
			]
		},
		{
			"id": 2,
			"frames": [
				{
					"framePosition": [24,0], "frameSize": [24,24]
				}
			],
			"hitbox": [
				{
					"boxSize": [24,24], "boxPosition": [0,0]
				}
			]
		},
		{
			"id": 3,
			"frames": [
				{
					"framePosition": [24,24], "frameSize": [24,24]
				}
			],
			"hitbox": [
				{
					"boxSize": [24,24], "boxPosition": [0,0]
				}
			]
		},
		{
			"id": 4,
			"frames": [
				{
					"framePosition": [48,24], "frameSize": [24,24]
				}
			],
			"hitbox": [
				{
					"boxSize": [24,24], "boxPosition": [0,0]
				}
			]
		},
		{
			"id": 5,
			"frames": [
				{
					"framePosition": [48,24], "frameSize": [24,24]
				}
			],
			"hitbox": [
				{
					"boxSize": [24,24], "boxPosition": [0,0]
				}
			],
			"slope": [0,24],
			"slopePosition": "bottom"
		},
		{
			"id": 6,
			"frames": [
				{
					"framePosition": [48,24], "frameSize": [24,24], "flip": -1
				}
			],
			"hitbox": [
				{
					"boxSize": [24,24], "boxPosition": [0,0]
				}
			],
			"slope": [24,0],
			"slopePosition": "bottom"
		},
		{
			"id": 7,
			"frames": [
				{
					"framePosition": [24,24], "frameSize": [24,24]
				}
			]
		},
		{
            "id": 9,
            "frames": [
                {
                    "framePosition": [24,48], "frameSize": [24, 24], "flip": -1
                }
            ],
            "hitbox": [
                {
                    "boxSize": [24,24], "boxPosition": [0,0]
                }
            ],
			"slope": [12,0],
			"slopePosition": "bottom"
        },
		{
            "id": 10,
            "frames": [
                {
                    "framePosition": [48,48], "frameSize": [24,24], "flip": -1
                }
            ],
            "hitbox": [
                {
                    "boxSize": [24,24], "boxPosition": [0,0]
                }
            ],
			"slope": [24,12],
			"slopePosition": "bottom"
        },
		{
            "id": 11,
            "frames": [
                {
                    "framePosition": [24,48], "frameSize": [24, 24]
                }
            ],
            "hitbox": [
                {
                    "boxSize": [24,24], "boxPosition": [0,0]
                }
            ],
			"slope": [0,12],
			"slopePosition": "bottom"
        },
		{
            "id": 12,
            "frames": [
                {
                    "framePosition": [48,48], "frameSize": [24,24]
                }
            ],
            "hitbox": [
                {
                    "boxSize": [24,24], "boxPosition": [0,0]
                }
            ],
			"slope": [12,24],
			"slopePosition": "bottom"
        }
		
	],
	"bg":{"x":0,
			"y":0,
			"width":108,
			"height":64,
			"sprite":"aptBg",
			"scale":6},
			
	"background": [
		[3, 0, 0, 0, 0, 0, 0, 0, 0, 0, 0, 0, 0, 0, 0, 0, 0,21, 3, 3, 3, 3, 3, 3, 3, 3, 3,30, 0, 0, 0, 0, 0, 0, 0, 0, 0, 0, 0, 0, 0, 0, 0, 0, 0, 0, 0, 0, 0, 0, 0, 0, 0, 0, 0, 0, 0, 3],
		[3, 0, 0, 0, 0, 0, 0, 0, 0, 0, 0, 0, 0, 0, 0, 0, 0,28, 7, 7, 7, 7, 7, 7, 7, 7, 7,30, 0, 0, 0, 0, 0, 0, 0, 0, 0, 0, 0, 0, 0, 0, 0, 0, 0, 0, 0, 0, 0, 0, 0, 0, 0, 0, 0, 0, 0, 3],
		[3, 0, 0, 0, 0, 0, 0, 0, 0, 0, 0, 0, 0, 0, 0, 0,21,40, 7, 7, 7, 7, 7, 7, 7, 7, 7,30, 0, 0, 0, 0, 0, 0, 0, 0, 0, 0, 0, 0, 0, 0, 0, 0, 0, 0, 0, 0, 0, 0, 0, 0, 0, 0, 0, 0, 0, 3],
		[3, 0, 0, 0, 0, 0, 0, 0, 0, 0, 0, 0, 0, 0, 0, 0,35,36,36,33, 7, 7, 7, 7, 7, 7, 7,30, 0, 0, 0, 0, 0, 0, 0, 0, 0, 0, 0, 0, 0, 0, 0, 0, 0, 0, 0, 0, 0, 0, 0, 0, 0, 0, 0, 0, 0, 3],
		[3, 0, 0, 0, 0, 0, 0, 0, 0, 0, 0, 0, 0, 0, 0, 0, 0, 0, 0,28, 7, 7, 7, 7, 7, 7, 7,30, 0, 0, 0, 0, 0, 0, 0, 0, 0, 0, 0, 0, 0, 0, 0, 0, 0, 0, 0, 0, 0, 0, 0, 0, 0, 0, 0, 0, 0, 3],
		[3, 0, 0, 0, 0, 0, 0, 0, 0, 0, 0, 0, 0, 0, 0, 0, 0, 0, 0,28, 7, 7, 7, 7, 7, 7, 7,30, 0, 0, 0, 0, 0, 0, 0, 0, 0, 0, 0, 0, 0, 0, 0, 0, 0, 0, 0, 0, 0, 0, 0, 0, 0, 0, 0, 0, 0, 3],
		[3, 0, 0, 0, 0, 0, 0, 0, 0, 0, 0, 0, 0, 0, 0,21,23, 0, 0,28, 7, 7, 7, 7, 7, 7, 7,30, 0, 0, 0, 0, 0, 0, 0, 0, 0, 0, 0, 0, 0, 0, 0, 0, 0, 0, 0, 0, 0, 0, 0, 0, 0, 0, 0, 0, 0, 3],
		[3, 0, 0, 0, 0, 0, 0, 0, 0, 0, 0, 0, 0, 0, 0,28,36,27, 0,28, 7, 7, 7, 7, 7, 7, 7,30, 0, 0, 0, 0, 0, 0, 0, 0, 0, 0, 0, 0, 0, 0, 0, 0, 0, 0, 0, 0, 0, 0, 0, 0, 0, 0, 0, 0, 0, 3],
		[3, 0, 0, 0, 0, 0, 0, 0, 0, 0, 0, 0, 0, 0, 0,31, 0, 0, 0,28, 7, 7, 7, 7, 7, 7, 7,30, 0, 0, 0, 0, 0, 0, 0, 0, 0, 0, 0, 0, 0, 0, 0, 0, 0, 0, 0, 0, 0, 0, 0, 0, 0, 0, 0, 0, 0, 3],
		[3, 0, 0, 0, 0, 0, 0, 0, 0, 0, 0, 0, 0, 0, 0,31, 0, 0, 0,28, 7, 7, 7, 7, 7, 7, 7,30, 0, 0, 0, 0, 0, 0, 0, 0, 0, 0, 0, 0, 0, 0, 0, 0, 0, 0, 0, 0, 0, 0, 0, 0, 0, 0, 0, 0, 0, 3],
		[3, 0, 0, 0, 0, 0, 0, 0, 0, 0, 0, 0, 0, 0, 0,38, 0,25,26,36,33, 7, 7, 7, 7, 7, 7,30, 0, 0, 0, 0, 0, 0, 0, 0, 0, 0, 0, 0, 0, 0, 0, 0, 0, 0, 0, 0, 0, 0, 0, 0, 0, 0, 0, 0, 0, 3],
		[3, 0, 0, 0, 0, 0, 0, 0, 0, 0, 0, 0, 0, 0, 0, 0, 0, 0, 0, 0,35,33, 7, 7, 7, 7, 7,30, 0, 0, 0, 0, 0, 0, 0, 0, 0, 0, 0, 0, 0, 0, 0, 0, 0, 0, 0, 0, 0, 0, 0, 8, 8, 0, 0, 0, 0, 3],
		[3, 0, 0, 0, 0, 0, 0, 0, 0, 0, 0, 0, 0, 0, 0, 0, 0, 0, 0, 0, 0,28, 7, 7, 7, 7, 7,30, 0, 0, 0, 0, 0, 0, 0, 0, 0, 0, 0, 0, 0, 0, 0, 0, 0, 0, 0, 0, 0, 8, 8, 0, 0, 0, 0, 0, 0, 3],
        [3, 0, 0, 0, 0, 0, 0, 0, 0, 0, 0, 0, 0, 0, 0,25,26,26,27, 0, 0,28, 7, 7, 7, 7, 7,30, 0, 0, 0, 0, 0, 0, 0, 0, 0, 0, 0, 0, 0, 0, 0, 0, 0, 0, 0, 0, 0, 0, 0, 0, 0, 0, 0, 0, 0, 3],
		[3, 0, 0, 0, 0, 0, 0, 0, 0, 0, 0, 0, 0, 0, 0, 0, 0, 0, 0, 0, 0,28, 7, 7, 7, 7, 7,30, 0, 0, 0, 0, 0, 0, 0, 0, 0, 0, 0, 0, 0, 0, 0, 0, 0, 0, 0, 0, 0, 0, 0, 0, 0, 0, 0, 0, 0, 3],
		[3, 0, 0, 0, 0, 0, 0, 0, 0, 0, 0, 0, 0, 0, 0, 0, 0, 0, 0, 0, 0,28, 7, 7, 7, 7, 7,30, 0, 0, 0, 0, 0, 0, 0, 0, 0, 0, 0, 0, 0, 0, 0, 0, 0, 0,25,26,26,26,26,26,26,27, 0, 0, 0, 3],
		[3, 3, 3, 0, 0, 0, 0, 0, 0, 0, 0, 0, 0, 0, 0, 0, 0, 0, 0, 0,25,36,36,36,36,33, 7,30, 0, 0, 0, 0, 0, 0, 0, 0, 0, 0, 0, 0, 0, 0, 0, 0, 0, 0, 0, 0, 0, 0, 0, 0, 0, 0, 0, 0, 0, 3],
		[3, 0, 0, 0, 0, 0, 0, 0, 0, 0, 0, 0, 0, 0, 0, 0, 0, 0, 0, 0, 0, 0, 0, 0, 0,28, 7,30, 0, 0, 0, 0, 0, 0, 0, 0, 0, 0, 0, 0, 0,25,27, 0, 0, 0, 0, 0, 0, 0, 0, 0, 0, 0, 0, 0, 0, 3],
		[3, 0, 0, 0, 0, 0, 0, 0, 0, 0, 0, 0, 0, 0, 0, 0, 0, 0, 0, 0, 0, 0, 0, 0, 0,28, 7,30, 0, 0, 0, 0, 0, 0, 0, 0, 0, 0, 0, 0, 0, 0, 0, 0, 0, 0, 0, 0, 0, 0, 0, 0, 0, 0, 0, 0, 0, 3],
		[3, 0, 0, 0, 0, 0, 0, 0, 0, 0, 0, 0, 0, 0, 0, 0, 0, 0, 0, 0, 0, 0, 0, 0, 0,28, 7,30, 0, 0, 0, 0, 0, 0, 0, 0, 0, 0, 0, 0, 0, 0, 0, 0, 0, 0, 0, 0, 0, 0, 0, 0, 0, 0, 0, 0, 0, 3], 
		[3, 0, 0, 0, 0, 0, 0, 0, 0, 0, 0, 0, 0, 0, 8, 8, 0, 0, 0, 0, 0, 5,23, 0,21,40, 7,39,22,22,23, 0, 0, 0, 0, 0, 0, 0, 0, 0, 0, 0, 0, 0, 0, 0, 0, 0, 0, 0, 0, 0, 0, 0, 0, 0, 0, 3], 
		[3, 0, 0, 0, 0, 0, 0, 0, 0, 0, 0, 0, 8, 8, 0, 0, 0, 0, 0, 0,21,40,39,22,40, 7, 7, 7, 7, 7,29,27, 0, 0, 0, 0, 0, 0, 0, 0, 0, 0, 0, 0, 0, 0, 0, 0, 0, 0, 0, 0, 0, 0, 0, 0, 0, 3], 
		[3, 3, 3, 3, 3, 3,10, 9, 0, 0, 0, 0, 0, 0, 0, 0, 0, 0,21,22,40, 7, 7, 7, 7, 7, 7, 7, 7,32,37, 0, 0, 0, 0, 0, 0, 0, 0, 0, 0, 0, 0, 0, 0, 0, 0, 0, 0, 0, 0, 0, 0, 0, 0, 0, 3, 3], 
		[1, 7, 7, 7, 7, 7, 3, 3,10, 9, 0, 0, 0, 0, 0, 0, 0,25,36,36,36,36,36,36,36,36,36,36,36,37, 0, 0, 0, 0, 0, 0, 0, 0, 0, 0, 0, 0, 0, 0, 0, 0, 0, 0,11,12,10, 9, 0, 0, 0, 0, 0, 3], 
		[1, 7, 7, 7, 7, 7, 7, 7, 7, 3, 3, 3,10, 9, 0, 0, 0, 0, 0, 0, 0, 0, 0, 0, 0, 0, 0, 0, 0, 0, 0, 0, 0, 0, 0, 0, 0, 0, 0, 0, 0, 0, 0, 0, 0, 0,11,12, 7, 7, 7, 7,10, 9, 0, 0, 0, 3], 
		[1, 7, 7, 7, 7, 7, 7, 7, 7, 7, 7, 7, 3, 3,10, 9, 0, 0, 0, 0, 0, 0, 0, 0, 0, 0, 0, 0, 0, 0, 0, 0, 0, 0, 0, 0, 0, 0, 0, 0, 0, 0, 0, 0,11,12, 7, 7, 7, 7, 7, 7, 7, 7,10, 9, 0, 3], 
		[1, 2, 2, 2, 2, 2, 2, 2, 2, 2, 2, 2, 2, 2, 2, 2, 2, 2, 2, 2, 2, 2, 2, 2, 2, 2, 2, 2, 2, 2, 2, 2, 2, 2, 2, 2, 2, 2, 2, 2, 2, 2, 2, 2, 2, 2, 2, 2, 2, 2, 2, 2, 2, 2, 2, 2, 2, 2], 
		[1, 7, 7, 7, 7, 7, 7, 7, 7, 7, 7, 7, 7, 7, 7, 7, 7, 7, 7, 7, 7, 7, 7, 7, 7, 7, 7, 7, 7, 7, 7, 7, 7, 7, 7, 7, 7, 7, 7, 7, 7, 7, 7, 7, 7, 7, 7, 7, 7, 7, 7, 7, 7, 7, 7, 7, 7, 1]
	],
	"objects":[
		{
			"id":1,
			"idName":"Dummy"
		},
		{
			"id":2,
			"idName":"Platform"
		},
		{
			"id":3,
			"idName":"Upgrade"
		},
		{
			"id":4,
			"idName":"Player"
		}
	],
	"objectSpawns":[
		{
			"id":1,
			"location":{"x":312, "y":528}
		},
		{
			"id":2,
			"location":{"x":312, "y":480}
		},
		{
			"id":3,
			"location":{"x":336, "y":456}
		},
		{
			"id":4,
			"location":{"x":48, "y":72}
		}
	],
	"levels":[
	"Street1",
	"Level3"]					
}